
111111111111111
100C00C00000001
1E00000P0000001
111111111111111
