1111111111
100P01E111
1C000C0E11
1111111111
