11111111111
11E00000K01
11111011011
1000C00C111
100C000P001
11111111111