11111111111
110E0000001
1111C000001
1CC00000101
1P000000C01
11111111111
