11111111111
11E00100001
11110000001
100C0000101
1000000P001
11111111111
